-=light
+=heavy
A=altimeter
AAL=above aerodrome level
ABV=above
AC=altocumulus
ACFT=aircraft
ACK=acknowledge
ACL=altimeter check location
ACLD=above clouds
ACLT=accelerate
ACPT=accept
ACR=air carrier
ACRS=across
ACSL=atanding lenticular altocumulus
ACT=active or activated or activity
ACTG=acting
ACTV=active
ACTVT=activate
ACYC=anticyclonic
ADA=advisory area
ADDN=addition
ADF=automatic direction finder
ADIZ=air defense identification zone
ADJ=adjacent
ADV=advise
ADVY=advisory
AFCT=affect
AFD=airport/facility directory
AFT=after
AFTN=afternoon
AGL=above ground level
AHD=ahead
AIM=aeronautical information manual
AIRMET=airmens meteorological information
ALF=aloft
ALG=along
ALT=altitude
ALTN=alternate
AMSL=above mean sea level
AOA=at or above
AOB=at or below
AS=altostratus
ASL=above sea level
ASPH=asphalt
ATA=actual time of arrival
ATIS=automatic terminal information service
AUTH=authorized
AUTO=without human intervention, automatic
AVG=average
AWY=airway
AZM=azimuth
B=began
BC=patches
BCM=become
BCMG=becoming
BECMG=The following weather phenomena are expected to arise soon:
BD=blowing dust
BFR=before
BGN=begin
BGNG=beginning
BGNS=begins
BHND=behind
BKN=broken cloud layer (5/8ths to 7/8ths)
BL=blowing
BLDG=building
BLDUP=buildup
BLO=below
BLZD=blizzard
BN=blowing sand
BND=bound
BR=mist 5/8
BRM=barometer
BS=blowing snow
BTWN=between
BYD=beyond
C=celsius
CAVOK=ceiling and visibility ok
CAVU=ceiling and visibility unlimited
CB=cumulonimbus
CC=cirrocumulus
CCSL=standing lenticular cirrocumulus
CHGD=changed
CHGS=changes
CI=cirrus
CIG=ceiling
CLD=cloud
CLR=sky clear at or below 12,000 agl
CNCL=cancel
CNTR=center
COND=conditions
CONT=continue
COORD=coordinate
COR=correction
COR=correction
CS=cirrostratus
CU=cumulus
CVR=cover
DCR=decrease
DMG=damage
DR=drifting
DS=dust storm
DSCNT=descent
DSNT=distant weather phenomenon
DSTC=distance
DU=dust
DZ=drizzle
E=east
E=ended
EMERG=emergency
ENDG=ending
ETIM=elapsed time
EXPC=expect
EXTD=extend
EXTRM=extreme
F=farenheit
FCST=forecast
FEW=few cloud layer (0/8ths to 2/8ths)
FG=fog
FLT=flight
FPM=feet per minute
FQTLY=frequently
FRZ=freeze
FRZG=freezing
FT=feet
FU=smoke
FWD=forward
FZ=freezing
FZFG=freezing fog
G=gust
GEN=general
GEO=geographic
GF=ground fog
GND=ground
GR=hail 5mm
GRDL=gradual
GS=small hail
GV=ground visibility
HDWND=head wind
HGT=height
HLSTO=hailstones
HR=hour
HRZN=horizon
HURCN=hurricane
HVY=heavy
HZ=haze
IC=ice
IC=ice crystals
ICG=icing
IMDT=immediate
IMPT=important
INCL=include
INCR=increase
INDC=indicate
INFO=information
INTL=international
KT=knots
LAT=latitude
LCL=local
LCTN=location
LDG=landing
LGT=light
LONG=longitude
LTG=lightning
M=minus, below zero, "less than"
METAR=meteorological terminal aviation routine weather report
MI=shallow
MSL=mean sea level
N=north
NEG=negative
NO=not available
NOSIG=no significant change expected
NSC=No significant clouds are observed below 5000 feet or below the minimum sector altitude (whichever is higher).
NSW=no significant weather
OAT=outside air temperature
OVC=overcast cloud layer (8/8ths coverage)
P=plus, "more than"
PK=wnd peak wind
PL=ice pellets
PO=welldeveloped dust/sand whirls
PR=partial
PRESFR/PRESRR=pressure falling or rising rapidly
PROB=probability of
PY=spray
Q=atmospheric pressure (in mmhg/hpa)
R=runway
RA=rain
RMK=remarks
RVRNO=runway visual range not available
RWY=runway
SA=sand
SCT=scattered cloud layer (3/8ths to 4/8ths)
SFC=vis surface visibility
SG=snow grains
SH=showers
SKC=sky clear
SLP=sea level pressure,
SLPNO=sea level pressure not available
SM=statute miles
SN=snow
SPECI=special metar report
SS=sandstorm
TCU=towering cumulus
TEMPO=temporarily
TS=thunderstorm
TURBC=turbulence
TURBT=turbulent
TWR=vis tower visibility
UP=unknown precipitation
V=varying
VA=volcanic ash
VC=in the vicinity
VRB=variable
VV=vertical visibility, indefinite ceiling
WRNG=warning
WS=wind shear
WSHFT=wind shift
WX=weather
ZL=freezing drizzle
ZR=freezing rain
